elma	apple	isim
armut	pear	isim
almak	take	fiil
iyi	good	sıfat
dünya	earth	isim
din	religion	isim
muz	banana	isim
çilek	strawberry	isim
iş	business	isim
ağaç	tree	isim
su	water	isim
yaş	age	isim
akıllı	smart	sıfat
yazılım	software	isim
bu	this	zamir
yoğurt	yogurt	isim
artı	plus	isim
masa	desk	isim
merhaba	hello	isim
sen	you	zamir
